8 10
2
2 1
7 2
4 7
1000000001
1100000011
0000000000
1000110001
1001111001
0001111000
0000110000
1100000011